1 =  460 -  450
2 = 690  
3 = 701 & 702
4 = 430 - 445
5 = 638 & 637
6 = 644
7 = 420 - 415
8 = 611 & 612
9 = 617 & 618
0 = 590 - 593
A = 1016
B = 907 & 908
C = 855 & 856
D = 817
# = 1000 - 995
* = 415 - 405

